alias k=kubectl
alias kco="kubectl config use-context"
alias context="kubectl config get-contexts"
alias kn="kubectl config set-context --current --namespace"
alias kdes="kubectl describe"
alias kdesp="kubectl describe po"
alias kdesd="kubectl describe deploy"
alias kg="kubectl get"
alias kgp="kubectl get pod"
alias kgd="kubectl get deploy"
alias kc="kubectl create"
alias kcd="kubectl create deploy"
alias kd="kubectl delete"
alias ked="kubectl edit"
alias ke="kubectl expose"
alias kex="kubectl explain --recursive"
alias kcurr="kubectl config current-context"
alias kgc="kubectl config get-contexts"
alias kr="kubectl run"
alias ktr="kubectl run tmp --image nginx --rm --restart Never -it -- curl"
alias kaf="kubectl apply -f"
alias kcf="kubectl create -f"
alias kdf="kubectl delete -f"
alias krf="kubectl replace --force -f"
alias ksi="kubectl set image"
alias kse="kubectl set env"
alias kl="kubectl logs"
alias krhd="kubectl rollout history deploy"
export do="--dry-run=client -oyaml"
export now="--grace-period=0 --force"
